111111111111111111111111111111111111
1P0000000000000000000000000000000001
111111111111111111111111111111111101
10000000000000000000C000000000000001
101111111111111111111111111111111111
1C0000000000000000000000000000000001
100000000001110000000111111100000001
100000000011100000000111111110000001
1000000001111111100C0000011110000001
100000000000001110000000111100000001
100000000000001110000111111110000001
100000000000000000000111111110000001
100000000000000000000000000000000C01
1E00000000000000000C0000000000000001
111111111111111111111111111111111111