1111111111111
100000C0001C1
1C00111110111
1P0011E000001
1111111111111